Name,Played,Wins,Draws,Losses,GF,GA,GoalDiff,Pts
Liverpool,5,5,0,0,14,2,12,15
Manchester City,5,5,0,0,9,1,8,15
West Ham United,5,3,1,1,11,5,6,10
Newcastle United,5,3,1,1,11,5,6,10
Wolverhampton Wanderers,5,3,1,1,6,4,2,10
Crystal Palace,5,3,1,1,12,10,2,10
Fulham,5,3,0,2,4,5,-1,9
Everton,5,2,2,1,8,4,4,8
AFC Bournemouth,5,2,1,2,12,9,3,7
Chelsea,5,1,3,1,6,5,1,6
Cardiff City,5,2,0,3,6,6,0,6
Leicester City,5,1,2,2,5,4,1,5
Tottenham Hotspur,5,1,1,3,3,5,-2,4
Burnley,5,1,1,3,5,8,-3,4
Arsenal,5,1,1,3,7,11,-4,4
Watford,5,1,1,3,5,11,-6,4
Brighton & Hove Albion,5,0,3,2,3,7,-4,3
Southampton,5,0,3,2,6,11,-5,3
Manchester United,5,0,2,3,2,10,-8,2
Huddersfield Town,5,0,2,3,3,13,-10,2
